........................KD..
.......................|####
.......................|....
.......................|....
............K......K...|....
........|..====..====..E....
........|...................
........|...................
........|...................
........E...................
.P...K..........K...........
############################
