.....................D..
...................|####
...................|....
...................|....
.............K.....|....
.......K....===....|....
......===..........|....
...................E....
.P......K...K...........
########################
