....................
......K........K....
.....===......===...
....................
.P...K...........D..
####################
